15x15
000000000000000
000000000000000
000000110000000
000000110000000
000000000000000
000000000000000
000011000000000
000011000000000
000000000000000
000000000000000
000000000000000
000000000000000
000110000000000
000110000000000
000000000000000